2 13 31
###############################
#      ** *  1 *   *  * * *   #
# # # #*# # #*#*# # # #*#*#*# #
#  x*  s  ***  *  1   *   * * #
# # # # # #*# # #*#*# # # # #*#
#   s     f  **  *  *   1     #
# # # # # # # # # #*# #*# # # #
#*  *   b  *  *   f  *        #
# # # # #*# # # #*#*# # # # # #
#*    **  *       *   f       #
# #*# # # # # # #*# # # # # # #
#   b   b   *   *  *         p#
###############################